NO ./textures/blue.png
SO ./textures/grey.png
WE ./textures/red.png
EA ./textures/green.png

F ,,
C ,,


111111111
100000001
100000001
10000W001
100000001
111111111
