11111111
10000001
10NSEW01
10000001
11111111
