NO ./textures/blue.png
SO ./textures/grey.png
WE ./textures/red.png
EA ./textures/green.png

F 0,155,90
C 0,90,155


111111111
100040001
1000N0041
140000001
100040001
100000001
100100001
110000001
100000041
100000011
100010001
111111111
