NO ./textures/blue.png
SO ./textures/grey.png
WE ./textures/red.png
EA ./textures/green.png

F 0,155,90
C 0,90,155


111141111
100000001
100000004
40000E001
100000001
111141111
