NO ./textures/blue.png
SO ./textures/grey.png
WE ./textures/red.png
EA ./textures/green.png

F 0,155,90
C 0,90,155


111111111111111111111111
100000000000000000010001
100000111111111100010001
100N00000000000000000001
100000000000000000000001
100000111111111000000001
100000000000000000000001
111111111111111111111111
