C 144,25,12
NO ./path_to_the_north_texture
SO ./path_to_the_south_texture
WE ./path_to_the_west_texture
EA ./path_to_the_east_texture
F 66,64,33

     11111111111111111
11111100001        101
100010010101       101
10N1 10100001111111101
10001001000000000000001
111000011111111111110001
111000000001  1000000001
  1110000001   10000001
    100011011111000001
     1001101110000111
      100000100011
       111100011
           111
